.#####.#####.#####.#######.#######.#####.
#.....#.....#.....#.......#.......#.....#
#.###.###.###.###.#.#.###.###.###.#.###.#
#.#.#...#.#.....#...#.#...#...#...#...#.#
#.#.###.#.#.#########.#.###.###.#####.#.#
#.#...#.#.#.#.........#...#...#.#.....#.#
#.#.#.#.#.#.#.###########.###.#.###.####.
#.#.#.#.#.#.#.#.#...#...#.....#...#.#...#
#.#.###.#.#.#.#.#.#.#.#.#########.#.#.#.#
#.#...#.#...#.#.#.#...#.........#.#.#.#.#
#.#.#.#.#####.#.#.#########.#####.#.#.#.#
#.#.#.........#.#.#.....#.#.......#...#.#
#.#.###########.#.#.###.#.#########.###.#
#.#.....#...#...#.#.#.....#.#.......#...#
#.#####.#.#.###.#.#.#####.#.#.#######.#.#
#.#.....#.#...#...#...#.#.#...#.....#.#.#
#.###.###.###.#.#####.#.#.###.#.#####.#.#
#...#.#.....#.#.......#.....#...#...#.#.#
.##.#.#.#####.#.###########.###.#.#.#.#.#
#...#.#.#.....#.#.......#.#.#...#.#.#.#.#
#.###.#.#.#######.#####.#.#.#####.#.#.##.
#...#.#.#...#...#.#*#...#.#.......#.#...#
.##.#.#.###.#.#.#.#.#.###.#########.###.#
#...#.#...#...#.#...#...#...#.......#...#
#.#######.#####.#######.###.#.#######.##.
#.......#.#...#.......#...#.#.#.....#...#
#.###.###.###.###.####.##.#.#.#.###.#.#.#
#.#.#.....#...#.#.....#...#...#...#...#.#
#.#.#######.#.#.#####.#.###.#########.#.#
#.#.#.......#.......#.#...#.........#.#.#
#.#.#.#####.###.#####.###.#########.###.#
#.#...#.....#...#.......#.....#...#.....#
#.###.#.#.#######.###########.###.#####.#
#...#.#.#.#.......#.........#.#.......#.#
.##.#.#.###.#.#####.###.###.#.#.#######.#
#.#.#.#...#.#.#...#...#.#...#.#...#.....#
#.#.#.###.#.#.#.#.###.#.#####.#.#.#.####.
#.#.#..!#.#.#.#.#...#.#.......#.#.#.#...#
#.#.#####.#.###.#.###.#########.#.#.#.#.#
#.........#.....#.....#.........#.....#.#
.#########.#####.#####.#########.#####.#.