####@##.#.#...##### F
####@####.#...##### F
####@...###...##### T
####@#..###...##### T
####@.#.###...#####
####@##.###...#####
####@..####...#####
####@#.####...#####
####@.#####...#####
####@######...#####
####@...#..#..#####
####@#..#..#..#####
####@.#.#..#..#####
####@##.#..#..#####
####@..##..#..#####
####@#.##..#..#####
####@.###..#..#####
####@####..#..#####
####@...##.#..#####
####@#..##.#..#####
####@.#.##.#..#####
####@##.##.#..#####
####@..###.#..#####
####@#.###.#..#####
####@.####.#..#####
####@#####.#..#####
####@...#.##..#####
####@#..#.##..#####
####@.#.#.##..#####
####@##.#.##..#####
####@..##.##..#####
####@#.##.##..#####
####@.###.##..#####
####@####.##..#####
####@...####..#####
####@#..####..#####
####@.#.####..#####
####@##.####..#####
####@..#####..#####
####@#.#####..#####
####@.######..#####
####@#######..#####
####@...#...#.#####
####@#..#...#.#####
####@.#.#...#.#####
####@##.#...#.#####
####@..##...#.#####
####@#.##...#.#####
####@.###...#.#####
####@####...#.#####
####@...##..#.#####
####@#..##..#.#####
####@.#.##..#.#####
####@##.##..#.#####
####@..###..#.#####
####@#.###..#.#####
####@.####..#.#####
####@#####..#.#####
####@...#.#.#.#####
####@#..#.#.#.#####
####@.#.#.#.#.#####
####@##.#.#.#.#####
####@..##.#.#.#####
####@#.##.#.#.#####
####@.###.#.#.#####
####@####.#.#.#####
####@...###.#.#####
####@#..###.#.#####
####@.#.###.#.#####
####@##.###.#.#####
####@..####.#.#####
####@#.####.#.#####
####@.#####.#.#####
####@######.#.#####
####@...#..##.#####
####@#..#..##.#####
####@.#.#..##.#####
####@##.#..##.#####
####@..##..##.#####
####@#.##..##.#####
####@.###..##.#####
####@####..##.#####
####@...##.##.#####
####@#..##.##.#####
####@.#.##.##.#####
####@##.##.##.#####
####@..###.##.#####
####@#.###.##.#####
####@.####.##.#####
####@#####.##.#####
####@...#.###.#####
####@#..#.###.#####
####@.#.#.###.#####
####@##.#.###.#####
####@..##.###.#####
####@#.##.###.#####
####@.###.###.#####
####@####.###.#####
####@...#####.#####
####@#..#####.#####
####@.#.#####.#####
####@##.#####.#####
####@..######.#####
####@#.######.#####
####@.#######.#####
####@########.#####
####@...##...######
####@#..##...######
####@.#.##...######
####@##.##...######
####@..###...######
####@#.###...######
####@.####...######
####@#####...######
####@...#.#..######
####@#..#.#..######
####@.#.#.#..######
####@##.#.#..######
####@..##.#..######
####@#.##.#..######
####@.###.#..######
####@####.#..######
####@...###..######
####@#..###..######
####@.#.###..######
####@##.###..######
####@..####..######
####@#.####..######
####@.#####..######
####@######..######
####@...#..#.######
####@#..#..#.######
####@.#.#..#.######
####@##.#..#.######
####@..##..#.######
####@#.##..#.######
####@.###..#.######
####@####..#.######
####@...##.#.######
####@#..##.#.######
####@.#.##.#.######
####@##.##.#.######
####@..###.#.######
####@#.###.#.######
####@.####.#.######
####@#####.#.######
####@...#.##.######
####@#..#.##.######
####@.#.#.##.######
####@##.#.##.######
####@..##.##.######
####@#.##.##.######
####@.###.##.######
####@####.##.######
####@...####.######
####@#..####.######
####@.#.####.######
####@##.####.######
####@..#####.######
####@#.#####.######
####@.######.######
####@#######.######
####@...#...#######
####@#..#...#######
####@.#.#...#######
####@##.#...#######
####@..##...#######
####@#.##...#######
####@.###...#######
####@####...#######
####@...##..#######
####@#..##..#######
####@.#.##..#######
####@##.##..#######
####@..###..#######
####@#.###..#######
####@.####..#######
####@#####..#######
####@...#.#.#######
####@#..#.#.#######
####@.#.#.#.#######
####@##.#.#.#######
####@..##.#.#######
####@#.##.#.#######
####@.###.#.#######
####@####.#.#######
####@...###.#######
####@#..###.#######
####@.#.###.#######
####@##.###.#######
####@..####.#######
####@#.####.#######
####@.#####.#######
####@######.#######
####@...#..########
####@#..#..########
####@.#.#..########
####@##.#..########
####@..##..########
####@#.##..########
####@.###..########
####@####..########
####@...##.########
####@#..##.########
####@.#.##.########
####@##.##.########
####@..###.########
####@#.###.########
####@.####.########
####@#####.########
####@...#.#########
####@#..#.#########
####@.#.#.#########
####@##.#.#########
####@..##.#########
####@#.##.#########
####@.###.#########
####@####.#########
####@...###########
####@#..###########
####@.#.###########
####@##.###########
####@..############
####@#.############
####@.#############
####@##############